1111111111111
1P0C001111111
100E0X0000001
1000001000001
1000000000001
1000000000001
1000000000001
1000000000001
1000000000001
1000000000001
1000000000001
1000000000001
1000000000001
1000000000001
1000000000001
1000000000001
1000000000001
1000000000001
1000000000001
1000000000001
1000000000001
1000000000001
1000000000001
1000000000001
1000000000001
1000000000001
1000000000001
1000000000001
1000000000001
1000000000001
1000000000001
1000000000001
1000000000001
1000000000001
1000000000001
1000000000001
1000000000001
1000000000001
1000000000001
1000000000001
1000000000001
1000000000001
1000000000001
1000000000001
1000000000001
1000000000001
1000000000001
1000000000001
1000000000001
1000000000001
1111111111111